EEEEEEEEEEEEEEEEEEEEEEE
EEEEEEEEEEEEEEEEE13443E
WWWWWWWWWWWW*E**WWWWWWW
2E1EWEEEEEEEEEEEE13443E
WWWWWWWWWWWW****WWWWWWW
2E1EYEEEEEEEEEEEy13443E
WWWWWWWWWWWWEE**WWWWWWW
EEEEEEEEEEEEEEEEEEEEEEE